gene	Preference	classification
ACHE	Inclusion	Tumor Suppressor
ARID5B	Inclusion	Tumor Suppressor
CD44	Inclusion	Tumor Suppressor
CD74	Inclusion	Oncogene
CDK4	Inclusion	Oncogene
DNAJC11	Inclusion	Tumor Suppressor
DNMT1	Inclusion	Both
EWSR1	Inclusion	Oncogene
FGFR3	Inclusion	Oncogene
FGFR4	Inclusion	Oncogene
IKBKE	Inclusion	Oncogene
KAT7	Inclusion	Oncogene
MGA	Inclusion	Tumor Suppressor
MIDEAS	Inclusion	Tumor Suppressor
MRE11	Inclusion	Tumor Suppressor
NFATC2	Inclusion	Tumor Suppressor
NUP214	Inclusion	Oncogene
PAK1	Inclusion	Oncogene
PBRM1	Inclusion	Tumor Suppressor
PHACTR4	Inclusion	Tumor Suppressor
PLD1	Inclusion	Tumor Suppressor
PML	Inclusion	Tumor Suppressor
PTPN13	Inclusion	Tumor Suppressor
QKI	Inclusion	Tumor Suppressor
RAF1	Inclusion	Oncogene
RASA1	Inclusion	Tumor Suppressor
SP100	Inclusion	Tumor Suppressor
SPEN	Inclusion	Tumor Suppressor
TCF4	Inclusion	Tumor Suppressor
TET2	Inclusion	Tumor Suppressor
TP53BP1	Inclusion	Tumor Suppressor
AHCYL1	Inclusion	Tumor Suppressor
AHRR	Inclusion	Tumor Suppressor
ATXN2	Inclusion	Tumor Suppressor
AXIN1	Inclusion	Tumor Suppressor
BECN1	Inclusion	Tumor Suppressor
BRF1	Inclusion	Tumor Suppressor
BRMS1	Inclusion	Tumor Suppressor
CBFB	Inclusion	Tumor Suppressor
CREM	Inclusion	Tumor Suppressor
CUL5	Inclusion	Tumor Suppressor
DDX58	Inclusion	Tumor Suppressor
DIABLO	Inclusion	Tumor Suppressor
DMTF1	Inclusion	Tumor Suppressor
ECSIT	Inclusion	Oncogene
EED	Inclusion	Tumor Suppressor
ELF4	Inclusion	Oncogene
ELN	Inclusion	Oncogene
ETV6	Inclusion	Tumor Suppressor
FAT1	Inclusion	Tumor Suppressor
FBXO31	Inclusion	Tumor Suppressor
GPX3	Inclusion	Tumor Suppressor
HDAC2	Inclusion	Oncogene
HIRA	Inclusion	Tumor Suppressor
ING4	Inclusion	Tumor Suppressor
IRF1	Inclusion	Tumor Suppressor
IRF3	Inclusion	Tumor Suppressor
JAK2	Inclusion	Oncogene
KMT2D	Inclusion	Tumor Suppressor
MIA2	Inclusion	Tumor Suppressor
MLH1	Inclusion	Tumor Suppressor
MLLT10	Inclusion	Oncogene
MTHFD2	Inclusion	Oncogene
MYD88	Inclusion	Oncogene
NEDD4	Inclusion	Tumor Suppressor
NPRL2	Inclusion	Tumor Suppressor
NT5C2	Inclusion	Oncogene
PDSS2	Inclusion	Tumor Suppressor
PER2	Inclusion	Tumor Suppressor
PHC3	Inclusion	Tumor Suppressor
PKD1	Inclusion	Tumor Suppressor
PTPN12	Inclusion	Tumor Suppressor
RAB7A	Inclusion	Tumor Suppressor
RAD51D	Inclusion	Tumor Suppressor
RUNX1	Inclusion	Tumor Suppressor
SDHC	Inclusion	Tumor Suppressor
SIRT6	Inclusion	Tumor Suppressor
SS18	Inclusion	Oncogene
STRADA	Inclusion	Tumor Suppressor
TAF1	Inclusion	Oncogene
TCF3	Inclusion	Tumor Suppressor
TP73	Inclusion	Tumor Suppressor
ZMYND11	Inclusion	Tumor Suppressor
LRP1B	Inclusion	Tumor Suppressor
NOTCH3	Inclusion	Both
SERPINI2	Inclusion	Tumor Suppressor
ABL2	Inclusion	Oncogene
AKR1B1	Inclusion	Tumor Suppressor
ATF3	Inclusion	Tumor Suppressor
CTNND1	Inclusion	Tumor Suppressor
CUL2	Inclusion	Tumor Suppressor
EZH2	Inclusion	Both
HINT1	Inclusion	Tumor Suppressor
HSP90B1	Inclusion	Tumor Suppressor
MAP3K14	Inclusion	Oncogene
RBMX	Inclusion	Tumor Suppressor
SMAD3	Inclusion	Tumor Suppressor
SMARCE1	Inclusion	Both
CIITA	Inclusion	Tumor Suppressor
FANCA	Inclusion	Tumor Suppressor
HDAC7	Inclusion	Oncogene
HTRA2	Inclusion	Tumor Suppressor
PLCD1	Inclusion	Tumor Suppressor
DPH1	Inclusion	Tumor Suppressor
ERBB2	Inclusion	Oncogene
CHEK2	Inclusion	Tumor Suppressor
GPS2	Inclusion	Tumor Suppressor
MADD	Inclusion	Tumor Suppressor
MAP3K13	Inclusion	Oncogene
DDX5	Inclusion	Oncogene
LMNA	Inclusion	Oncogene
RNF8	Inclusion	Tumor Suppressor
SCG5	Inclusion	Oncogene
CYLD	Inclusion	Tumor Suppressor
RBM5	Inclusion	Tumor Suppressor
RPS6KA4	Inclusion	Oncogene
TERT	Inclusion	Oncogene
AKT2	Skipping	Oncogene
ATXN2	Skipping	Tumor Suppressor
CASP8	Skipping	Tumor Suppressor
CD44	Skipping	Tumor Suppressor
CEACAM1	Skipping	Tumor Suppressor
CREM	Skipping	Tumor Suppressor
DENND2B	Skipping	Tumor Suppressor
ELN	Skipping	Oncogene
EP400	Skipping	Tumor Suppressor
FGFR1	Skipping	Oncogene
FGFR2	Skipping	Oncogene
GSTP1	Skipping	Tumor Suppressor
KMT2A	Skipping	Tumor Suppressor
MKI67	Skipping	Oncogene
MLLT10	Skipping	Oncogene
NEDD4L	Skipping	Tumor Suppressor
NTRK2	Skipping	Oncogene
PAK1	Skipping	Oncogene
RBM4	Skipping	Tumor Suppressor
RPTOR	Skipping	Oncogene
SAMHD1	Skipping	Tumor Suppressor
SCYL1	Skipping	Tumor Suppressor
SEPTIN4	Skipping	Tumor Suppressor
SP100	Skipping	Tumor Suppressor
SRGAP3	Skipping	Tumor Suppressor
TSC2	Skipping	Tumor Suppressor
UBE4B	Skipping	Tumor Suppressor
ABRAXAS1	Skipping	Tumor Suppressor
ASXL1	Skipping	Tumor Suppressor
ATF3	Skipping	Tumor Suppressor
ATM	Skipping	Tumor Suppressor
BCL2L11	Skipping	Tumor Suppressor
BRF1	Skipping	Tumor Suppressor
CAMTA1	Skipping	Tumor Suppressor
CCNDBP1	Skipping	Tumor Suppressor
CHEK2	Skipping	Tumor Suppressor
CHFR	Skipping	Tumor Suppressor
DCUN1D1	Skipping	Oncogene
DDB2	Skipping	Tumor Suppressor
DLG1	Skipping	Tumor Suppressor
DMD	Skipping	Tumor Suppressor
DNMT1	Skipping	Both
DPH1	Skipping	Tumor Suppressor
EMSY	Skipping	Oncogene
EPB41	Skipping	Tumor Suppressor
ERCC1	Skipping	Tumor Suppressor
EWSR1	Skipping	Oncogene
EZH2	Skipping	Both
FANCE	Skipping	Tumor Suppressor
FBXO25	Skipping	Tumor Suppressor
FYN	Skipping	Oncogene
GLI1	Skipping	Both
HDAC2	Skipping	Oncogene
HDAC7	Skipping	Oncogene
IRF2	Skipping	Tumor Suppressor
KDM6A	Skipping	Tumor Suppressor
MAP4K4	Skipping	Oncogene
MEF2C	Skipping	Both
MGA	Skipping	Tumor Suppressor
MYB	Skipping	Oncogene
MYO5A	Skipping	Oncogene
NPM1	Skipping	Tumor Suppressor
PLAAT2	Skipping	Tumor Suppressor
PMS1	Skipping	Tumor Suppressor
POU2F2	Skipping	Oncogene
RUNX2	Skipping	Tumor Suppressor
SS18	Skipping	Oncogene
TBRG1	Skipping	Tumor Suppressor
TCF4	Skipping	Tumor Suppressor
TCF7L2	Skipping	Tumor Suppressor
TP53BP1	Skipping	Tumor Suppressor
TRIT1	Skipping	Tumor Suppressor
UHRF2	Skipping	Tumor Suppressor
CACNA2D3	Skipping	Tumor Suppressor
FBLN1	Skipping	Tumor Suppressor
NOTCH2	Skipping	Both
TNFRSF10B	Skipping	Tumor Suppressor
SMARCA2	Skipping	Tumor Suppressor
DNAJC11	Skipping	Tumor Suppressor
HDAC1	Skipping	Both
NF1	Skipping	Tumor Suppressor
PKD1	Skipping	Tumor Suppressor
PML	Skipping	Tumor Suppressor
SLX4	Skipping	Tumor Suppressor
STK11	Skipping	Tumor Suppressor
ADARB1	Skipping	Tumor Suppressor
BAX	Skipping	Tumor Suppressor
ECSIT	Skipping	Oncogene
KRIT1	Skipping	Tumor Suppressor
MBD6	Skipping	Tumor Suppressor
BANP	Skipping	Tumor Suppressor
CD74	Skipping	Oncogene
ETF1	Skipping	Tumor Suppressor
PIGA	Skipping	Tumor Suppressor
RAD51C	Skipping	Tumor Suppressor
CNOT3	Skipping	Tumor Suppressor
MADD	Skipping	Tumor Suppressor
PLCD1	Skipping	Tumor Suppressor
LMNA	Skipping	Oncogene
MOB1A	Skipping	Tumor Suppressor
RACK1	Skipping	Tumor Suppressor
ROBO1	Skipping	Tumor Suppressor
KANK1	Skipping	Tumor Suppressor
NUP214	Skipping	Oncogene
TFE3	Skipping	Oncogene
